was - was not found in the dictionary. Similar words: as gas war wash way 
creep - was not found in the dictionary. Similar words: career cheer crew deep free green keep sheep sleep tree 
detestable - was not found in the dictionary. Similar words: vegetable 
flame - was not found in the dictionary. Similar words: blame 
towering - was not found in the dictionary. Similar words: bring during govern modern morning nothing power seeking spring thing toward town wrong 
lone - was not found in the dictionary. Similar words: alone bone line long lose love 
its - was not found in the dictionary. Similar words: it 
onyx - was not found in the dictionary. Similar words: any on once only 
castle - was not found in the dictionary. Similar words: battle case taste waste 
vast - was not found in the dictionary. Similar words: east fast last past 
hippocephalic - was not found in the dictionary. Similar words: appeal 
abomination - was not found in the dictionary. Similar words: ammunition 
leaped - was not found in the dictionary. Similar words: lead leave 
doomed - was not found in the dictionary. Similar words: come door food former good home room some wood 
lava - was not found in the dictionary. Similar words: have lack lake land last late law leave live love navy save slave wave 
gatherers - was not found in the dictionary. Similar words: gather 
image - was not found in the dictionary. Similar words: age damage imagine make male mate 
makers - was not found in the dictionary. Similar words: make 
could - was not found in the dictionary. Similar words: cold 
one - was not found in the dictionary. Similar words: bone on once owe 
phosphorescent - was not found in the dictionary. Similar words: present represent 
clouds - was not found in the dictionary. Similar words: cloud 
beheld - was not found in the dictionary. Similar words: behind 
those - was not found in the dictionary. Similar words: these 
lawn - was not found in the dictionary. Similar words: law 
vicar - was not found in the dictionary. Similar words: car visa 
s - was not found in the dictionary. Similar words: a as i so us 
carriage - was not found in the dictionary. Similar words: arrive 
waiting - was not found in the dictionary. Similar words: wait willing 
his - was not found in the dictionary. Similar words: hit this 
creatures - was not found in the dictionary. Similar words: creature 
were - was not found in the dictionary. Similar words: here where wire 
reserved - was not found in the dictionary. Similar words: observe receive serve 
ignominious - was not found in the dictionary. Similar words: nominate opinion 
kinds - was not found in the dictionary. Similar words: kind 
masters - was not found in the dictionary. Similar words: matter mystery 
being - was not found in the dictionary. Similar words: bring 
sickened - was not found in the dictionary. Similar words: sickness succeed 
despite - was not found in the dictionary. Similar words: desire dispute 
their - was not found in the dictionary. Similar words: cheer hair hear other tear the them then theory there these they thin third this 
messenger - was not found in the dictionary. Similar words: passenger 
revealed - was not found in the dictionary. Similar words: release 
truant - was not found in the dictionary. Similar words: treat trust 
gods - was not found in the dictionary. Similar words: god goods 
whose - was not found in the dictionary. Similar words: whole 
steps - was not found in the dictionary. Similar words: step 
magahs - was not found in the dictionary. Similar words: again gas march mass wages 
nest - was not found in the dictionary. Similar words: best next rest test west 
hint - was not found in the dictionary. Similar words: hit hunt 
shores - was not found in the dictionary. Similar words: share shoe short store 
ring - was not found in the dictionary. Similar words: bring sing 
stones - was not found in the dictionary. Similar words: stone 
carter - was not found in the dictionary. Similar words: career 
knew - was not found in the dictionary. Similar words: know new 
zoog - was not found in the dictionary. Similar words: zoo 
background - was not found in the dictionary. Similar words: around ground 
made - was not found in the dictionary. Similar words: make male mate 
stars - was not found in the dictionary. Similar words: star start 
towers - was not found in the dictionary. Similar words: power toward 
titan - was not found in the dictionary. Similar words: than total 
scattered - was not found in the dictionary. Similar words: attend capture matter 
rocks - was not found in the dictionary. Similar words: rock 
whispered - was not found in the dictionary. Similar words: speed where 
beneath - was not found in the dictionary. Similar words: beat breathe defeat repeat senate 
suspicious - was not found in the dictionary. Similar words: serious suicide surplus suspect 
nourishment - was not found in the dictionary. Similar words: equipment 
into - was not found in the dictionary. Similar words: in it no to veto 
darkening - was not found in the dictionary. Similar words: during morning 
had - was not found in the dictionary. Similar words: bad hard hat head sad 
warned - was not found in the dictionary. Similar words: warn 
him - was not found in the dictionary. Similar words: aim hit 
would - was not found in the dictionary. Similar words: world wound 
learned - was not found in the dictionary. Similar words: learn 
though - was not found in the dictionary. Similar words: through 
thought - was not found in the dictionary. Similar words: through 
certain - was not found in the dictionary. Similar words: contain detain 
slant - was not found in the dictionary. Similar words: plant 
eyed - was not found in the dictionary. Similar words: bed end even ever feed need red seed yes yet 
yath - was not found in the dictionary. Similar words: path 
shore - was not found in the dictionary. Similar words: share shoe short store 
inland - was not found in the dictionary. Similar words: island 
singular - was not found in the dictionary. Similar words: similar single 
fluttering - was not found in the dictionary. Similar words: during letter 
councils - was not found in the dictionary. Similar words: cancel concern confirm count country until 
themselves - was not found in the dictionary. Similar words: these 
cast - was not found in the dictionary. Similar words: case cat coast cost east fast last past 
flying - was not found in the dictionary. Similar words: along blind bring during find fine flag fluid fly line link long sing spring thing willing 
void - was not found in the dictionary. Similar words: avoid 
likewise - was not found in the dictionary. Similar words: disease like wise 
bent - was not found in the dictionary. Similar words: beat best 
lovely - was not found in the dictionary. Similar words: lonely 
strain - was not found in the dictionary. Similar words: train 
song - was not found in the dictionary. Similar words: long sing son 
darkness - was not found in the dictionary. Similar words: sickness 
discern - was not found in the dictionary. Similar words: concern desert dinner disarm discover discuss listen sister 
upon - was not found in the dictionary. Similar words: iron moon noon on open son soon up 
vaster - was not found in the dictionary. Similar words: after matter sister taste waste water 
loomed - was not found in the dictionary. Similar words: blood come flood food former good home load look lose loud love room some wood 
presences - was not found in the dictionary. Similar words: present 
wills - was not found in the dictionary. Similar words: will 
shrieking - was not found in the dictionary. Similar words: seeking 
noxious - was not found in the dictionary. Similar words: serious 
downward - was not found in the dictionary. Similar words: forward toward 
least - was not found in the dictionary. Similar words: east last 
believed - was not found in the dictionary. Similar words: believe 
course - was not found in the dictionary. Similar words: cause court cure horse house worse 
unpleasant - was not found in the dictionary. Similar words: plant please pregnant present represent understand unless 
shadows - was not found in the dictionary. Similar words: show 
flitting - was not found in the dictionary. Similar words: building lightning listen little missing nothing thing willing 
feebly - was not found in the dictionary. Similar words: feel 
luminous - was not found in the dictionary. Similar words: business famous minor serious 
expanse - was not found in the dictionary. Similar words: expand 
traveller - was not found in the dictionary. Similar words: travel 
delight - was not found in the dictionary. Similar words: light 
days - was not found in the dictionary. Similar words: day 
asked - was not found in the dictionary. Similar words: ask seed 
seized - was not found in the dictionary. Similar words: seize 
dragged - was not found in the dictionary. Similar words: danger 
ashore - was not found in the dictionary. Similar words: share shoe short store 
aspect - was not found in the dictionary. Similar words: affect expect inspect respect suspect 
invoked - was not found in the dictionary. Similar words: invade invite involve 
sacrificially - was not found in the dictionary. Similar words: sacrifice 
bearded - was not found in the dictionary. Similar words: border 
commanded - was not found in the dictionary. Similar words: command 
koth - was not found in the dictionary. Similar words: both 
beware - was not found in the dictionary. Similar words: before 
cave - was not found in the dictionary. Similar words: care case have save wave 
cemetery - was not found in the dictionary. Similar words: center century 
expansive - was not found in the dictionary. Similar words: examine expand offensive 
slab - was not found in the dictionary. Similar words: stab 
realise - was not found in the dictionary. Similar words: raise 
are - was not found in the dictionary. Similar words: age area art care rare 
gates - was not found in the dictionary. Similar words: date game gas gather hate late mate rate wages water 
monstrous - was not found in the dictionary. Similar words: control 
cataract - was not found in the dictionary. Similar words: attach attack camera catch contact correct natural start target 
wherein - was not found in the dictionary. Similar words: where 
oceans - was not found in the dictionary. Similar words: ocean 
steadily - was not found in the dictionary. Similar words: steal 
refused - was not found in the dictionary. Similar words: refuse 
conjecture - was not found in the dictionary. Similar words: connect creature 
broken - was not found in the dictionary. Similar words: brown 
columns - was not found in the dictionary. Similar words: colony count 
crumbling - was not found in the dictionary. Similar words: combine 
sphinxes - was not found in the dictionary. Similar words: shine 
fearful - was not found in the dictionary. Similar words: careful fear 
frightful - was not found in the dictionary. Similar words: frighten 
litten - was not found in the dictionary. Similar words: listen 
revolting - was not found in the dictionary. Similar words: revolt 
procession - was not found in the dictionary. Similar words: profession 
arabesques - was not found in the dictionary. Similar words: request rescue 
inlaid - was not found in the dictionary. Similar words: island 
windowed - was not found in the dictionary. Similar words: window 
houses - was not found in the dictionary. Similar words: house 
somewhat - was not found in the dictionary. Similar words: meat seat some what 
narrower - was not found in the dictionary. Similar words: narrow 
highway - was not found in the dictionary. Similar words: high 
led - was not found in the dictionary. Similar words: bed lead lend let red 
dwelt - was not found in the dictionary. Similar words: debt diet melt sweet well west wet 
within - was not found in the dictionary. Similar words: thin with 
tunnel - was not found in the dictionary. Similar words: cancel dinner fuel hunger tense travel tube turn under until 
granite - was not found in the dictionary. Similar words: grain organize praise raise rate unite write 
leads - was not found in the dictionary. Similar words: lead 
formed - was not found in the dictionary. Similar words: former 
ten - was not found in the dictionary. Similar words: tea then 
distributed - was not found in the dictionary. Similar words: describe dispute 
amongst - was not found in the dictionary. Similar words: among 
gusto - was not found in the dictionary. Similar words: custom dust just must oust 
recalled - was not found in the dictionary. Similar words: because call female read real receive record recover valley 
spitting - was not found in the dictionary. Similar words: spring 
caterwauling - was not found in the dictionary. Similar words: material 
faintly - was not found in the dictionary. Similar words: fail family final paint 
stern - was not found in the dictionary. Similar words: star start steal steam steel step store storm story term turn 
shone - was not found in the dictionary. Similar words: shine shoe stone 
sunset - was not found in the dictionary. Similar words: sense 
lit - was not found in the dictionary. Similar words: fit hit it let lie lift list sit 
taken - was not found in the dictionary. Similar words: take 
account - was not found in the dictionary. Similar words: amount count 
moment - was not found in the dictionary. Similar words: comment movement 
hesitation - was not found in the dictionary. Similar words: situation station 
comers - was not found in the dictionary. Similar words: camera come cover 
is - was not found in the dictionary. Similar words: as i if in it us 
bronze - was not found in the dictionary. Similar words: bone 
nor - was not found in the dictionary. Similar words: for no not now or 
pavements - was not found in the dictionary. Similar words: movement 
tiled - was not found in the dictionary. Similar words: tired 
streets - was not found in the dictionary. Similar words: street 
doorways - was not found in the dictionary. Similar words: always door forward 
endless - was not found in the dictionary. Similar words: unless 
precipices - was not found in the dictionary. Similar words: politics predict price receive 
ngranek - was not found in the dictionary. Similar words: agree bank brave drink engine game grain grass gray green grind insane name parade partner planet race rape rare rate shrink strange tank thank trade travel 
told - was not found in the dictionary. Similar words: cold gold hold old 
seen - was not found in the dictionary. Similar words: see seed seem 
carven - was not found in the dictionary. Similar words: care career 
thereon - was not found in the dictionary. Similar words: there 
contract - was not found in the dictionary. Similar words: contact 
principal - was not found in the dictionary. Similar words: criminal 
changed - was not found in the dictionary. Similar words: change 
captain - was not found in the dictionary. Similar words: contain 
landing - was not found in the dictionary. Similar words: land 
guest - was not found in the dictionary. Similar words: best burst dust get great just must oust rest test west 
talked - was not found in the dictionary. Similar words: take talk 
times - was not found in the dictionary. Similar words: time 
having - was not found in the dictionary. Similar words: hang 
scrollwork - was not found in the dictionary. Similar words: color 
blossoming - was not found in the dictionary. Similar words: missing 
vines - was not found in the dictionary. Similar words: fine line mine video 
shantak - was not found in the dictionary. Similar words: thank 
sending - was not found in the dictionary. Similar words: seeking 
skyward - was not found in the dictionary. Similar words: award forward toward 
homing - was not found in the dictionary. Similar words: among bring combine during hang home human join joint long mind mine morning nothing point sing spring thing woman young 
hearing - was not found in the dictionary. Similar words: bring during earn hang hear learn seeking spring 
tombstone - was not found in the dictionary. Similar words: combine postpone stone 
lever - was not found in the dictionary. Similar words: ever level never 
raising - was not found in the dictionary. Similar words: missing rain raise sing 
ghouls - was not found in the dictionary. Similar words: should 
concerning - was not found in the dictionary. Similar words: concern 
tower - was not found in the dictionary. Similar words: power 
escaped - was not found in the dictionary. Similar words: escape 
ghasts - was not found in the dictionary. Similar words: glass grass 
waking - was not found in the dictionary. Similar words: along among bring during gain hang kind main pain paint rain seeking sing skin spring thing wait want warn willing win wind wrong 
infancy - was not found in the dictionary. Similar words: infect insane 
lay - was not found in the dictionary. Similar words: day law may pay play say way 
words - was not found in the dictionary. Similar words: word 
came - was not found in the dictionary. Similar words: camp care case come game name same 
things - was not found in the dictionary. Similar words: thing 
dylath - was not found in the dictionary. Similar words: clash cloth date debate delay donate flat late path 
leen - was not found in the dictionary. Similar words: bleed clean deep even feed feel flee green keep lead leak learn left lend less let level lie loan mean meet need open see seed seem sleep then week when 
cosmopolitan - was not found in the dictionary. Similar words: complete hospital 
folk - was not found in the dictionary. Similar words: book cold cook fall fill film fly fog food fool foot for form full gold hold hole holy look milk old rock roll talk walk work 
chiefly - was not found in the dictionary. Similar words: chief 
gossiped - was not found in the dictionary. Similar words: consider hostile missile possible 
discerned - was not found in the dictionary. Similar words: discover disease internet 
strangely - was not found in the dictionary. Similar words: strange 
wrought - was not found in the dictionary. Similar words: rough 
yak - was not found in the dictionary. Similar words: a an as ask at back bad ban bank bar can car cat dam dark day eat fan far fat gas hat lack lake law leak make man map mark may pay sad say take talk tank tax walk war way weak year yes yet you 
drawn - was not found in the dictionary. Similar words: drown 
chariots - was not found in the dictionary. Similar words: champion charge crisis crops cross riot serious 
climbed - was not found in the dictionary. Similar words: climb 
alley - was not found in the dictionary. Similar words: ally valley 
wished - was not found in the dictionary. Similar words: wise wish 
quest - was not found in the dictionary. Similar words: best burst dust just must oust quiet request rest test west 
understood - was not found in the dictionary. Similar words: understand 
carefully - was not found in the dictionary. Similar words: careful 
shod - was not found in the dictionary. Similar words: shoe show 
turbaned - was not found in the dictionary. Similar words: husband 
haggle - was not found in the dictionary. Similar words: able age agree argue battle change charge half halt hang hate have hole huge large male single 
shops - was not found in the dictionary. Similar words: crops hope shape ship shock shoe shoot short shout show stop 
men - was not found in the dictionary. Similar words: man mean 
gave - was not found in the dictionary. Similar words: game give have save wave 
giant - was not found in the dictionary. Similar words: gift plant want 
foundations - was not found in the dictionary. Similar words: condition 
picked - was not found in the dictionary. Similar words: ice kick like nice piece pipe price rice rocket sick tired 
loathsome - was not found in the dictionary. Similar words: bottom home late lose postpone some 
ill - was not found in the dictionary. Similar words: all bill fill hill kill will 
disposed - was not found in the dictionary. Similar words: discover disease dispute 
midst - was not found in the dictionary. Similar words: first list miss most must 
nightmare - was not found in the dictionary. Similar words: negotiate night 
rang - was not found in the dictionary. Similar words: hang 
warning - was not found in the dictionary. Similar words: morning 
strength - was not found in the dictionary. Similar words: strange street stretch strong 
savagery - was not found in the dictionary. Similar words: anger damage danger every save severe very 
unimpaired - was not found in the dictionary. Similar words: compare 
till - was not found in the dictionary. Similar words: bill fill hill kill still tall tell will 
atal - was not found in the dictionary. Similar words: all at away coal deal goal heal meal metal real stab star stay steal talk tall tax total 
said - was not found in the dictionary. Similar words: aid raid sad sail sand 
depths - was not found in the dictionary. Similar words: debt depend deploy 
mouth - was not found in the dictionary. Similar words: month south 
townsfolk - was not found in the dictionary. Similar words: control tool town transport 
fond - was not found in the dictionary. Similar words: find food 
jewellers - was not found in the dictionary. Similar words: jewel 
indoors - was not found in the dictionary. Similar words: door inform 
central - was not found in the dictionary. Similar words: control general mental neutral 
did - was not found in the dictionary. Similar words: aid die dig 
clutch - was not found in the dictionary. Similar words: catch cloth 
tickle - was not found in the dictionary. Similar words: circle ice kick like little middle nice rice sick simple single stick take thick tie time trick 
dim - was not found in the dictionary. Similar words: aim dam die dig 
wastes - was not found in the dictionary. Similar words: waste 
lurked - was not found in the dictionary. Similar words: cure curfew lake large like luck market murder pure red sure tired urge 
peril - was not found in the dictionary. Similar words: evil period permit 
detection - was not found in the dictionary. Similar words: direction 
weeks - was not found in the dictionary. Similar words: week 
found - was not found in the dictionary. Similar words: round sound wound 
thorabonian - was not found in the dictionary. Similar words: tradition train 
been - was not found in the dictionary. Similar words: ban be beat bed begin best bleed born burn deep even feed feel green keep mean meet need open see seed seem then week when 
terraces - was not found in the dictionary. Similar words: peace race series service surface teach terrible terror terrorist threaten trade travel truce 
menace - was not found in the dictionary. Similar words: fence peace senate 
limned - was not found in the dictionary. Similar words: line 
tiny - was not found in the dictionary. Similar words: any city deny find fine in kind line link many mind mine sing sink tank they thin thing think tie time try win wind 
distant - was not found in the dictionary. Similar words: distance 
permitted - was not found in the dictionary. Similar words: permit 
zoogs - was not found in the dictionary. Similar words: goods zoo 
slink - was not found in the dictionary. Similar words: link sink 
respective - was not found in the dictionary. Similar words: respect 
justified - was not found in the dictionary. Similar words: justice 
ghoul - was not found in the dictionary. Similar words: goal group hour should shout 
began - was not found in the dictionary. Similar words: begin 
ahead - was not found in the dictionary. Similar words: head 
snowy - was not found in the dictionary. Similar words: snow 
peak - was not found in the dictionary. Similar words: leak speak weak 
aran - was not found in the dictionary. Similar words: again an area arms army art away ban brain can earn fan grain gray iron loan man mean plan pray rain run than train trap warn 
capacious - was not found in the dictionary. Similar words: across campaign capital famous relations serious vacation 
burrow - was not found in the dictionary. Similar words: borrow 
crawled - was not found in the dictionary. Similar words: crowd 
hours - was not found in the dictionary. Similar words: hour 
squatted - was not found in the dictionary. Similar words: square 
mountains - was not found in the dictionary. Similar words: mountain 
gambol - was not found in the dictionary. Similar words: game labor 
hills - was not found in the dictionary. Similar words: hill 
converse - was not found in the dictionary. Similar words: concern cover universe 
none - was not found in the dictionary. Similar words: bone note 
rejoin - was not found in the dictionary. Similar words: join remain 
unmarked - was not found in the dictionary. Similar words: market 
ulthar - was not found in the dictionary. Similar words: clear either father gather mother other star tear than that 
passed - was not found in the dictionary. Similar words: pass 
sleek - was not found in the dictionary. Similar words: sleep 
excitement - was not found in the dictionary. Similar words: equipment excellent experiment 
galley - was not found in the dictionary. Similar words: valley 
discovery - was not found in the dictionary. Similar words: discover 
headland - was not found in the dictionary. Similar words: demand expand head heal health husband island land 
humans - was not found in the dictionary. Similar words: human 
slain - was not found in the dictionary. Similar words: again brain claim gain grain main pain plan rain sail skin slave train 
hidden - was not found in the dictionary. Similar words: hide sudden 
saw - was not found in the dictionary. Similar words: law sad say 
infinite - was not found in the dictionary. Similar words: incite invite 
gulfs - was not found in the dictionary. Similar words: bus full gas gift glass gold goods grass guard guide guilty gun half pull rule self us 
became - was not found in the dictionary. Similar words: become 
numb - was not found in the dictionary. Similar words: bomb jump name number pump rub 
somnolent - was not found in the dictionary. Similar words: comment innocent 
moving - was not found in the dictionary. Similar words: morning movie 
automatic - was not found in the dictionary. Similar words: automobile 
impulse - was not found in the dictionary. Similar words: improve simple 
crag - was not found in the dictionary. Similar words: can car cat coal crash crew cry drug flag gray pray trap 
gasped - was not found in the dictionary. Similar words: base case ease game gas gather happen paper rape seed speed spend suspend taste waste 
cried - was not found in the dictionary. Similar words: brief chief child crew crime crowd friend grind red 
aloud - was not found in the dictionary. Similar words: cloud loud 
clutched - was not found in the dictionary. Similar words: clothes 
jagged - was not found in the dictionary. Similar words: age agree anger danger judge large target wages 
frightened - was not found in the dictionary. Similar words: frighten 
timid - was not found in the dictionary. Similar words: limit time tired 
known - was not found in the dictionary. Similar words: know 
creeping - was not found in the dictionary. Similar words: seeking 
gug - was not found in the dictionary. Similar words: gun 
nipping - was not found in the dictionary. Similar words: missing nothing spring willing 
tearing - was not found in the dictionary. Similar words: bring during earn learn seeking spring tear thing train 
muzzles - was not found in the dictionary. Similar words: bullet male middle murder rule surplus unless 
mount - was not found in the dictionary. Similar words: amount count 
repugnant - was not found in the dictionary. Similar words: pregnant 
shantaks - was not found in the dictionary. Similar words: shake thank 
helping - was not found in the dictionary. Similar words: belong help seeking willing 
judgement - was not found in the dictionary. Similar words: budget judge movement urgent 
sets - was not found in the dictionary. Similar words: set 
perfumed - was not found in the dictionary. Similar words: perfect perform period permit persuade refugee refuse 
gardens - was not found in the dictionary. Similar words: green pardon parent 
beckoning - was not found in the dictionary. Similar words: belong seeking 
dismal - was not found in the dictionary. Similar words: animal deal disarm disease dismiss final normal signal small usual visa 
basalt - was not found in the dictionary. Similar words: salt 
two - was not found in the dictionary. Similar words: to too 
sailed - was not found in the dictionary. Similar words: sail sailor 
eastward - was not found in the dictionary. Similar words: award 
thankful - was not found in the dictionary. Similar words: thank 
presence - was not found in the dictionary. Similar words: present 
weight - was not found in the dictionary. Similar words: weigh 
importance - was not found in the dictionary. Similar words: important 
madness - was not found in the dictionary. Similar words: mass witness 
taunt - was not found in the dictionary. Similar words: count hunt paint tank trust want 
nyarlathotep - was not found in the dictionary. Similar words: parachute 
marked - was not found in the dictionary. Similar words: market 
sunning - was not found in the dictionary. Similar words: during morning seeking sing spring 
himself - was not found in the dictionary. Similar words: self 
pavement - was not found in the dictionary. Similar words: movement 
extended - was not found in the dictionary. Similar words: extend 
honeycombed - was not found in the dictionary. Similar words: become welcome 
summits - was not found in the dictionary. Similar words: summer 
according - was not found in the dictionary. Similar words: accident morning 
advice - was not found in the dictionary. Similar words: advise 
